scale		fScale
ibmx		ibmx
igrid		iGrid
nobject		iNObject
ibnum		iBoundNum
uniformdiel	bUniformDiel
oldmid		cOldMid
rmid		fRMid
limgunit	sLimGridUnit
limobject	sLimObject
rdmx		fRMax
rionst		fIonStrenth
exrad		fExternRadius
limeps		LimEps
idebmap		bDebMap
#iepsmp		#iEpsMap
delphipdb	sDelPhiPDB
gaussian	iGaussian
verbose		bVerbose
natom		iNatom
xn2		xn2
xn1		xn1
iatmmed		iAtomMed
nmedia		iNMedia
ionlymol	bOnlyMol
radprb  	fRadPrb
cmin		cMin
cmax		cMax
debug		bDebug
iabs		abs
%i		.nX
%j		.nY
%k		.nZ
%x		.nX
%y		.nY
%z		.nZ
%rad3		.radius
%chrgv4		.charge
%min		.nMin
%max		.nMax
